+——————————————————————————————————————————————————————+
|                                                      |
|                                                      |
|                                                      |
|                                                      |
|                                                      |
|                                                      |
|——————————————————————————————————————————————————————|
|+                                                    +|
||                                                    ||
||  +——+  +——————+  +——————————————+  +——————+  +——+  ||
||  |  |  |      |  |              |  |      |  |  |  ||
||  |  |  |      |  |              |  |      |  |  |  ||
||  |  |  |      |  |  +————————+  |  |      |  |  |  ||
||  |  |  |      |  |  |        |  |  |      |  |  |  ||
||  |  |  +——————+  |  |        |  |  +——————+  |  |  ||
||  |  |            |  |  +——+  |  |            |  |  ||
||  |  |            |  |  |  |  |  |            |  |  ||
||  |  +———+  +——+  |  |  |  |  |  |  +——+  +———+  |  ||
||  |      |  |  |  |  |  |  |  |  |  |  |  |      |  ||
||  |      |  |  |  |  |  |  |  |  |  |  |  |      |  ||
||  +——————+  |  |  +——+  |  |  +——+  |  |  +——————+  ||
||            |  |        |  |        |  |            ||
|+            |  |        |  |        |  |            +|
|————+  +—————+  +—————+  |  |  +—————+  +—————+  +————|
+————|  |              |  |  |  |              |  |————+
    +|  |              |  |  |  |              |  |+    
    ||  +—————+  +—————+  +——+  +—————+  +—————+  ||    
    ||        |  |                    |  |        ||    
    +|        |  |                    |  |        |+    
+————|  +——+  |  |  +————+    +————+  |  |  +——+  |————+
+————+  |  |  |  |  |————+    +————|  |  |  |  |  +————+
        |  |  |  |  |+            +|  |  |  |  |        
        |  |  +——+  ||            ||  +——+  |  |        
+———————+  |        ||            ||        |  +———————+
|          |        ||            ||        |          |
|          |  +——+  ||            ||  +——+  |          |
+———————+  |  |  |  |+            +|  |  |  |  +———————+
        |  |  |  |  |——————————————|  |  |  |  |        
        |  |  |  |  +——————————————+  |  |  |  |        
+————+  |  |  |  |                    |  |  |  |  +————+
+————|  +——+  |  |                    |  |  +——+  |————+
    +|        |  +—————+  +——+  +—————+  |        |+    
    ||        |        |  |  |  |        |        ||    
    ||  +——+  |        |  |  |  |        |  +——+  ||    
    ||  |  |  +————————+  |  |  +————————+  |  |  ||    
    ||  |  |              |  |              |  |  ||    
    ||  |  |              |  |              |  |  ||    
    ||  |  +—————+  +——+  |  |  +——+  +—————+  |  ||    
    +|  |        |  |  |  |  |  |  |  |        |  |+    
+————|  |        |  |  |  |  |  |  |  |        |  |————+
|————+  +————————+  |  |  +——+  |  |  +————————+  +————|
|+                  |  |        |  |                  +|
||                  |  |        |  |                  ||
||  +——————+  +——+  |  +————————+  |  +——+  +——————+  ||
||  |      |  |  |  |              |  |  |  |      |  ||
||  |      |  |  |  |              |  |  |  |      |  ||
||  |  +———+  |  |  +——————————————+  |  |  +———+  |  ||
||  |  |      |  |                    |  |      |  |  ||
||  |  |      |  |                    |  |      |  |  ||
||  |  |  +———+  +—————+  +——+  +—————+  +———+  |  |  ||
||  |  |  |            |  |  |  |            |  |  |  ||
||  |  |  |            |  |  |  |            |  |  |  ||
||  +——+  +————————————+  |  |  +————————————+  +——+  ||
||                        |  |                        ||
|+                        |  |                        +|
|—————————————————————————+  +—————————————————————————|
|                                                      |
|                                                      |
|                                                      |
|                                                      |
+——————————————————————————————————————————————————————+
