+——————————————————————————————————————————————————————+
|                                                      |
|                                                      |
|                                                      |
|                                                      |
|                                                      |
|                                                      |
|———————————————————+  +————————+  +———————————————————|
|+                  |  |        |  |                  +|
||                  |  |        |  |                  ||
||  +————————————+  |  |  +——+  |  |  +————————————+  ||
||  |            |  |  |  |  |  |  |  |            |  ||
||  |            |  |  |  |  |  |  |  |            |  ||
||  |  +—————————+  +——+  |  |  +——+  +—————————+  |  ||
||  |  |                  |  |                  |  |  ||
||  |  |                  |  |                  |  |  ||
||  |  |  +——+  +——————+  |  |  +——————+  +——+  |  |  ||
||  +——+  |  |  |      |  |  |  |      |  |  |  +——+  ||
||        |  |  |      |  |  |  |      |  |  |        ||
|+        |  |  |      |  |  |  |      |  |  |        +|
|——————+  |  |  |      |  |  |  |      |  |  |  +——————|
|      |  |  |  +——————+  +——+  +——————+  |  |  |      |
|      |  |  |                            |  |  |      |
+——————+  |  |                            |  |  +——————+
          |  +———+  +——————————————+  +———+  |          
          |      |  |              |  |      |          
++  +——+  |      |  |              |  |      |  +——+  ++
||  |  |  +——————+  +——————————————+  +——————+  |  |  ||
||  |  |                                        |  |  ||
||  |  |                                        |  |  ||
||  |  +———+  +——+  +————+    +————+  +——+  +———+  |  ||
||  |      |  |  |  |————+    +————|  |  |  |      |  ||
||  |      |  |  |  |+            +|  |  |  |      |  ||
||  +——————+  |  |  ||            ||  |  |  +——————+  ||
||            |  |  ||            ||  |  |            ||
||            |  |  ||            ||  |  |            ||
||  +——+  +———+  |  ||            ||  |  +———+  +——+  ||
||  |  |  |      |  |+            +|  |      |  |  |  ||
||  |  |  |      |  |——————————————|  |      |  |  |  ||
||  |  |  +——————+  +——————————————+  +——————+  |  |  ||
||  |  |                                        |  |  ||
||  |  |                                        |  |  ||
||  |  +———+  +————————+  +——+  +————————+  +———+  |  ||
||  |      |  |        |  |  |  |        |  |      |  ||
||  |      |  |        |  |  |  |        |  |      |  ||
||  +——————+  |  +—————+  |  |  +—————+  |  +——————+  ||
||            |  |        |  |        |  |            ||
|+            |  |        |  |        |  |            +|
|————+  +——+  |  |  +—————+  +—————+  |  |  +——+  +————|
|    |  |  |  |  |  |              |  |  |  |  |  |    |
|    |  |  |  |  |  |              |  |  |  |  |  |    |
|————+  |  |  +——+  +——————————————+  +——+  |  |  +————|
|+      |  |                                |  |      +|
||      |  |                                |  |      ||
||  +———+  |  +————————+  +——+  +————————+  |  +———+  ||
||  |      |  |        |  |  |  |        |  |      |  ||
||  |      |  |        |  |  |  |        |  |      |  ||
||  +——————+  |  +—————+  |  |  +—————+  |  +——————+  ||
||            |  |        |  |        |  |            ||
||            |  |        |  |        |  |            ||
||  +——————+  |  |  +—————+  +—————+  |  |  +——————+  ||
||  |      |  |  |  |              |  |  |  |      |  ||
||  |      |  |  |  |              |  |  |  |      |  ||
||  +——————+  |  |  +——————————————+  |  |  +——————+  ||
||            |  |                    |  |            ||
|+            |  |                    |  |            +|
|—————————————+  +————————————————————+  +—————————————|
|                                                      |
|                                                      |
|                                                      |
|                                                      |
+——————————————————————————————————————————————————————+
