+——————————————————————————————————————————————————————+
|                                                      |
|                                                      |
|                                                      |
|                                                      |
|                                                      |
|                                                      |
+—————————————+  +————————————————————+  +—————————————+
              |  |                    |  |              
              |  |                    |  |              
+——————————+  |  |  +——————————————+  |  |  +——————————+
|          |  |  |  |              |  |  |  |          |
|          |  |  |  |              |  |  |  |          |
|——————————+  +——+  +—————+  +—————+  +——+  +——————————|
|+                        |  |                        +|
||                        |  |                        ||
||  +————————————+  +——+  |  |  +——+  +————————————+  ||
||  |            |  |  |  |  |  |  |  |            |  ||
||  |            |  |  |  |  |  |  |  |            |  ||
||  |  +—————————+  |  |  |  |  |  |  +—————————+  |  ||
||  |  |            |  |  |  |  |  |            |  |  ||
||  |  |            |  |  +——+  |  |            |  |  ||
||  |  |  +——————+  |  |        |  |  +——————+  |  |  ||
||  |  |  |      |  |  |        |  |  |      |  |  |  ||
||  |  |  |      |  |  +————————+  |  |      |  |  |  ||
||  +——+  +———+  |  |              |  |  +———+  +——+  ||
||            |  |  |              |  |  |            ||
|+            |  |  +——————————————+  |  |            +|
|——————————+  |  |                    |  |  +——————————|
|          |  |  |                    |  |  |          |
|          |  |  |  +————+    +————+  |  |  |          |
|——————————+  |  |  |————+    +————|  |  |  +——————————|
|+            |  |  |+            +|  |  |            +|
||            |  |  ||            ||  |  |            ||
||  +——————+  |  |  ||            ||  |  |  +——————+  ||
||  |      |  +——+  ||            ||  +——+  |      |  ||
||  |      |        ||            ||        |      |  ||
||  +———+  |        |+            +|        |  +———+  ||
||      |  |  +——+  |——————————————|  +——+  |  |      ||
|+      |  |  |  |  +——————————————+  |  |  |  |      +|
|————+  |  |  |  |                    |  |  |  |  +————|
+————|  |  |  |  |                    |  |  |  |  |————+
    +|  |  |  |  +———+  +——————+  +———+  |  |  |  |+    
    ||  |  |  |      |  |      |  |      |  |  |  ||    
    ||  |  |  |      |  |      |  |      |  |  |  ||    
    ||  +——+  +——————+  |      |  +——————+  +——+  ||    
    ||                  |      |                  ||    
    ||                  |      |                  ||    
    ||  +————————————+  |      |  +————————————+  ||    
    +|  |            |  |      |  |            |  |+    
+————|  |            |  |      |  |            |  |————+
+————+  +—————+  +———+  +——————+  +———+  +—————+  +————+
              |  |                    |  |              
              |  |                    |  |              
+————+  +——+  |  |  +——————————————+  |  |  +——+  +————+
|    |  |  |  |  |  |              |  |  |  |  |  |    |
|    |  |  |  |  |  |              |  |  |  |  |  |    |
|————+  |  |  +——+  +—————+  +—————+  +——+  |  |  +————|
|+      |  |              |  |              |  |      +|
||      |  |              |  |              |  |      ||
||  +———+  |  +————————+  |  |  +————————+  |  +———+  ||
||  |      |  |        |  |  |  |        |  |      |  ||
||  |      |  |        |  |  |  |        |  |      |  ||
||  +——————+  +————————+  +——+  +————————+  +——————+  ||
||                                                    ||
|+                                                    +|
|——————————————————————————————————————————————————————|
|                                                      |
|                                                      |
|                                                      |
|                                                      |
+——————————————————————————————————————————————————————+
