+——————————————————————————————————————————————————————————————————————————————————————————————————————————————+
|                                                                                                              |
|                                                                                                              |
|                                                                                                              |
|                                                                                                              |
|                                                                                                              |
|                                                                                                              |
|                                                                                                              |
|                                                                                                              |
|                                                                                                              |
|                                                                                                              |
|                                                                                                              |
|                                                                                                              |
|                                                                                                              |
|                                                                                                              |
|  +————————————————————————————————————+      +————————————————+      +————————————————————————————————————+  |
|  |                                    |      |                |      |                                    |  |
|  |                                    |      |                |      |                                    |  |
|  |                                    |      |                |      |                                    |  |
|  |                                    |      |                |      |                                    |  |
|  |    +——————————————————————————+    |      |    +——————+    |      |    +——————————————————————————+    |  |
|  |    |                          |    |      |    |      |    |      |    |                          |    |  |
|  |    |                          |    |      |    |      |    |      |    |                          |    |  |
|  |    |                          |    |      |    |      |    |      |    |                          |    |  |
|  |    |                          |    |      |    |      |    |      |    |                          |    |  |
|  |    |                          |    |      |    |      |    |      |    |                          |    |  |
|  |    |                          |    |      |    |      |    |      |    |                          |    |  |
|  |    |      +———————————————————+    +——————+    |      |    +——————+    +———————————————————+      |    |  |
|  |    |      |                                    |      |                                    |      |    |  |
|  |    |      |                                    |      |                                    |      |    |  |
|  |    |      |                                    |      |                                    |      |    |  |
|  |    |      |                                    |      |                                    |      |    |  |
|  |    |      |    +——————+    +——————————————+    |      |    +——————————————+    +——————+    |      |    |  |
|  |    |      |    |      |    |              |    |      |    |              |    |      |    |      |    |  |
|  |    |      |    |      |    |              |    |      |    |              |    |      |    |      |    |  |
|  |    +——————+    |      |    |              |    |      |    |              |    |      |    +——————+    |  |
|  |                |      |    |              |    |      |    |              |    |      |                |  |
|  |                |      |    |              |    |      |    |              |    |      |                |  |
|  |                |      |    |              |    |      |    |              |    |      |                |  |
|  |                |      |    |              |    |      |    |              |    |      |                |  |
|  +———————————+    |      |    |              |    |      |    |              |    |      |    +———————————+  |
|              |    |      |    |              |    |      |    |              |    |      |    |              |
|              |    |      |    |              |    |      |    |              |    |      |    |              |
|              |    |      |    +——————————————+    +——————+    +——————————————+    |      |    |              |
|              |    |      |                                                        |      |    |              |
|              |    |      |                                                        |      |    |              |
|              |    |      |                                                        |      |    |              |
+——————————————+    |      |                                                        |      |    +——————————————+
                    |      +———————+    +——————————————————————————————+    +———————+      |                    
                    |              |    |                              |    |              |                    
                    |              |    |                              |    |              |                    
                    |              |    |                              |    |              |                    
+——+    +——————+    |              |    |                              |    |              |    +——————+    +——+
|  |    |      |    |              |    |                              |    |              |    |      |    |  |
|  |    |      |    |              |    |                              |    |              |    |      |    |  |
|  |    |      |    +——————————————+    +——————————————————————————————+    +——————————————+    |      |    |  |
|  |    |      |                                                                                |      |    |  |
|  |    |      |                                                                                |      |    |  |
|  |    |      |                                                                                |      |    |  |
|  |    |      |                                                                                |      |    |  |
|  |    |      +———————+    +——————+    +——————————+        +——————————+    +——————+    +———————+      |    |  |
|  |    |              |    |      |    |          |        |          |    |      |    |              |    |  |
|  |    |              |    |      |    |          |        |          |    |      |    |              |    |  |
|  |    |              |    |      |    |  +———————+        +———————+  |    |      |    |              |    |  |
|  |    |              |    |      |    |  |                        |  |    |      |    |              |    |  |
|  |    |              |    |      |    |  |                        |  |    |      |    |              |    |  |
|  |    |              |    |      |    |  |                        |  |    |      |    |              |    |  |
|  |    +——————————————+    |      |    |  |                        |  |    |      |    +——————————————+    |  |
|  |                        |      |    |  |                        |  |    |      |                        |  |
|  |                        |      |    |  |                        |  |    |      |                        |  |
|  |                        |      |    |  |                        |  |    |      |                        |  |
|  |                        |      |    |  |                        |  |    |      |                        |  |
|  |    +——————+    +———————+      |    |  |                        |  |    |      +———————+    +——————+    |  |
|  |    |      |    |              |    |  |                        |  |    |              |    |      |    |  |
|  |    |      |    |              |    |  |                        |  |    |              |    |      |    |  |
|  |    |      |    |              |    |  |                        |  |    |              |    |      |    |  |
|  |    |      |    |              |    |  +————————————————————————+  |    |              |    |      |    |  |
|  |    |      |    |              |    |                              |    |              |    |      |    |  |
|  |    |      |    |              |    |                              |    |              |    |      |    |  |
|  |    |      |    +——————————————+    +——————————————————————————————+    +——————————————+    |      |    |  |
|  |    |      |                                                                                |      |    |  |
|  |    |      |                                                                                |      |    |  |
|  |    |      |                                                                                |      |    |  |
|  |    |      |                                                                                |      |    |  |
|  |    |      +———————+    +——————————————————+    +——————+    +——————————————————+    +———————+      |    |  |
|  |    |              |    |                  |    |      |    |                  |    |              |    |  |
|  |    |              |    |                  |    |      |    |                  |    |              |    |  |
|  |    |              |    |                  |    |      |    |                  |    |              |    |  |
|  |    |              |    |                  |    |      |    |                  |    |              |    |  |
|  |    |              |    |                  |    |      |    |                  |    |              |    |  |
|  |    |              |    |                  |    |      |    |                  |    |              |    |  |
|  |    +——————————————+    |      +———————————+    |      |    +———————————+      |    +——————————————+    |  |
|  |                        |      |                |      |                |      |                        |  |
|  |                        |      |                |      |                |      |                        |  |
|  |                        |      |                |      |                |      |                        |  |
|  |                        |      |                |      |                |      |                        |  |
|  +———————+    +——————+    |      |    +———————————+      +———————————+    |      |    +——————+    +———————+  |
|          |    |      |    |      |    |                              |    |      |    |      |    |          |
|          |    |      |    |      |    |                              |    |      |    |      |    |          |
|          |    |      |    |      |    |                              |    |      |    |      |    |          |
|          |    |      |    |      |    |                              |    |      |    |      |    |          |
|          |    |      |    |      |    |                              |    |      |    |      |    |          |
|          |    |      |    |      |    |                              |    |      |    |      |    |          |
|  +———————+    |      |    +——————+    +——————————————————————————————+    +——————+    |      |    +———————+  |
|  |            |      |                                                                |      |            |  |
|  |            |      |                                                                |      |            |  |
|  |            |      |                                                                |      |            |  |
|  |            |      |                                                                |      |            |  |
|  |    +———————+      |    +——————————————————+    +——————+    +——————————————————+    |      +———————+    |  |
|  |    |              |    |                  |    |      |    |                  |    |              |    |  |
|  |    |              |    |                  |    |      |    |                  |    |              |    |  |
|  |    |              |    |                  |    |      |    |                  |    |              |    |  |
|  |    |              |    |                  |    |      |    |                  |    |              |    |  |
|  |    |              |    |                  |    |      |    |                  |    |              |    |  |
|  |    |              |    |                  |    |      |    |                  |    |              |    |  |
|  |    +——————————————+    |      +———————————+    |      |    +———————————+      |    +——————————————+    |  |
|  |                        |      |                |      |                |      |                        |  |
|  |                        |      |                |      |                |      |                        |  |
|  |                        |      |                |      |                |      |                        |  |
|  |                        |      |                |      |                |      |                        |  |
|  |    +——————————————+    |      |    +———————————+      +———————————+    |      |    +——————————————+    |  |
|  |    |              |    |      |    |                              |    |      |    |              |    |  |
|  |    |              |    |      |    |                              |    |      |    |              |    |  |
|  |    |              |    |      |    |                              |    |      |    |              |    |  |
|  |    |              |    |      |    |                              |    |      |    |              |    |  |
|  |    |              |    |      |    |                              |    |      |    |              |    |  |
|  |    |              |    |      |    |                              |    |      |    |              |    |  |
|  |    +——————————————+    |      |    +——————————————————————————————+    |      |    +——————————————+    |  |
|  |                        |      |                                        |      |                        |  |
|  |                        |      |                                        |      |                        |  |
|  |                        |      |                                        |      |                        |  |
|  |                        |      |                                        |      |                        |  |
|  +————————————————————————+      +————————————————————————————————————————+      +————————————————————————+  |
|                                                                                                              |
|                                                                                                              |
|                                                                                                              |
|                                                                                                              |
|                                                                                                              |
|                                                                                                              |
|                                                                                                              |
|                                                                                                              |
|                                                                                                              |
|                                                                                                              |
+——————————————————————————————————————————————————————————————————————————————————————————————————————————————+
