+——————————————————————————————————————————————————————————————————————————————————————————————————————————————+
|                                                                                                              |
|                                                                                                              |
|                                                                                                              |
|                                                                                                              |
|                                                                                                              |
|                                                                                                              |
|                                                                                                              |
|                                                                                                              |
|                                                                                                              |
|                                                                                                              |
|                                                                                                              |
|                                                                                                              |
|                                                                                                              |
|                                                                                                              |
|  +————————————————————————+      +————————————————————————————————————————+      +————————————————————————+  |
|  |                        |      |                                        |      |                        |  |
|  |                        |      |                                        |      |                        |  |
|  |                        |      |                                        |      |                        |  |
|  |                        |      |                                        |      |                        |  |
|  |    +——————————————+    |      |    +——————————————————————————————+    |      |    +——————————————+    |  |
|  |    |              |    |      |    |                              |    |      |    |              |    |  |
|  |    |              |    |      |    |                              |    |      |    |              |    |  |
|  |    |              |    |      |    |                              |    |      |    |              |    |  |
|  |    |              |    |      |    |                              |    |      |    |              |    |  |
|  |    |              |    |      |    |                              |    |      |    |              |    |  |
|  |    |              |    |      |    |                              |    |      |    |              |    |  |
|  |    +——————————————+    +——————+    +——————————————————————————————+    +——————+    +——————————————+    |  |
|  |                                                                                                        |  |
|  |                                                                                                        |  |
|  |                                                                                                        |  |
|  |                                                                                                        |  |
|  +———————+    +——————+    +——————————————————+    +——————+    +——————————————————+    +——————+    +———————+  |
|          |    |      |    |                  |    |      |    |                  |    |      |    |          |
|          |    |      |    |                  |    |      |    |                  |    |      |    |          |
+———————+  |    |      |    |                  |    |      |    |                  |    |      |    |  +———————+
        |  |    |      |    |                  |    |      |    |                  |    |      |    |  |        
        |  |    |      |    |                  |    |      |    |                  |    |      |    |  |        
        |  |    |      |    |                  |    |      |    |                  |    |      |    |  |        
        |  |    |      |    |                  |    |      |    |                  |    |      |    |  |        
+———————+  |    |      |    |                  |    |      |    |                  |    |      |    |  +———————+
|          |    |      |    |                  |    |      |    |                  |    |      |    |          |
|          |    |      |    |                  |    |      |    |                  |    |      |    |          |
+——————————+    |      |    +——————————————————+    |      |    +——————————————————+    |      |    +——————————+
                |      |                            |      |                            |      |                
                |      |                            |      |                            |      |                
                |      |                            |      |                            |      |                
                |      |                            |      |                            |      |                
+——————————+    |      +———————————+    +———————————+      +———————————+    +———————————+      |    +——————————+
|          |    |                  |    |                              |    |                  |    |          |
|          |    |                  |    |                              |    |                  |    |          |
+———————+  |    |                  |    |                              |    |                  |    |  +———————+
        |  |    |                  |    |                              |    |                  |    |  |        
        |  |    |                  |    |                              |    |                  |    |  |        
        |  |    |                  |    |                              |    |                  |    |  |        
        |  |    +——————————————————+    +——————————————————————————————+    +——————————————————+    |  |        
        |  |                                                                                        |  |        
        |  |                                                                                        |  |        
        |  |                                                                                        |  |        
        |  |                                                                                        |  |        
        |  |    +——————————————————+    +——————————+        +——————————+    +——————————————————+    |  |        
        |  |    |                  |    |          |        |          |    |                  |    |  |        
        |  |    |                  |    |          |        |          |    |                  |    |  |        
        |  |    |                  |    |  +———————+        +———————+  |    |                  |    |  |        
        |  |    |                  |    |  |                        |  |    |                  |    |  |        
        |  |    |                  |    |  |                        |  |    |                  |    |  |        
        |  |    |                  |    |  |                        |  |    |                  |    |  |        
        |  |    |      +———————————+    |  |                        |  |    +———————————+      |    |  |        
        |  |    |      |                |  |                        |  |                |      |    |  |        
        |  |    |      |                |  |                        |  |                |      |    |  |        
        |  |    |      |                |  |                        |  |                |      |    |  |        
        |  |    |      |                |  |                        |  |                |      |    |  |        
        |  |    |      |    +——————+    |  |                        |  |    +——————+    |      |    |  |        
        |  |    |      |    |      |    |  |                        |  |    |      |    |      |    |  |        
        |  |    |      |    |      |    |  |                        |  |    |      |    |      |    |  |        
        |  |    |      |    |      |    |  |                        |  |    |      |    |      |    |  |        
+———————+  |    |      |    |      |    |  +————————————————————————+  |    |      |    |      |    |  +———————+
|          |    |      |    |      |    |                              |    |      |    |      |    |          |
|          |    |      |    |      |    |                              |    |      |    |      |    |          |
+——————————+    +——————+    |      |    +——————————————————————————————+    |      |    +——————+    +——————————+
                            |      |                                        |      |                            
                            |      |                                        |      |                            
                            |      |                                        |      |                            
                            |      |                                        |      |                            
+——————————+    +———————————+      +———————————+    +——————+    +———————————+      +———————————+    +——————————+
|          |    |                              |    |      |    |                              |    |          |
|          |    |                              |    |      |    |                              |    |          |
+———————+  |    |                              |    |      |    |                              |    |  +———————+
        |  |    |                              |    |      |    |                              |    |  |        
        |  |    |                              |    |      |    |                              |    |  |        
        |  |    |                              |    |      |    |                              |    |  |        
        |  |    +——————————————————————————————+    |      |    +——————————————————————————————+    |  |        
        |  |                                        |      |                                        |  |        
        |  |                                        |      |                                        |  |        
        |  |                                        |      |                                        |  |        
        |  |                                        |      |                                        |  |        
        |  |    +——————————————————+    +———————————+      +———————————+    +——————————————————+    |  |        
        |  |    |                  |    |                              |    |                  |    |  |        
        |  |    |                  |    |                              |    |                  |    |  |        
        |  |    |                  |    |                              |    |                  |    |  |        
+———————+  |    |                  |    |                              |    |                  |    |  +———————+
|          |    |                  |    |                              |    |                  |    |          |
|          |    |                  |    |                              |    |                  |    |          |
|  +———————+    +——————————————————+    +——————————————————————————————+    +——————————————————+    +———————+  |
|  |                                                                                                        |  |
|  |                                                                                                        |  |
|  |                                                                                                        |  |
|  |                                                                                                        |  |
|  |    +——————————————+    +——————————————————+    +——————+    +——————————————————+    +——————————————+    |  |
|  |    |              |    |                  |    |      |    |                  |    |              |    |  |
|  |    |              |    |                  |    |      |    |                  |    |              |    |  |
|  |    |              |    |                  |    |      |    |                  |    |              |    |  |
|  |    |              |    |                  |    |      |    |                  |    |              |    |  |
|  |    |              |    |                  |    |      |    |                  |    |              |    |  |
|  |    |              |    |                  |    |      |    |                  |    |              |    |  |
|  |    |              |    |      +———————————+    |      |    +———————————+      |    |              |    |  |
|  |    |              |    |      |                |      |                |      |    |              |    |  |
|  |    |              |    |      |                |      |                |      |    |              |    |  |
|  |    |              |    |      |                |      |                |      |    |              |    |  |
|  |    |              |    |      |                |      |                |      |    |              |    |  |
|  |    |              |    |      |    +———————————+      +———————————+    |      |    |              |    |  |
|  |    |              |    |      |    |                              |    |      |    |              |    |  |
|  |    |              |    |      |    |                              |    |      |    |              |    |  |
|  |    |              |    |      |    |                              |    |      |    |              |    |  |
|  |    |              |    |      |    |                              |    |      |    |              |    |  |
|  |    |              |    |      |    |                              |    |      |    |              |    |  |
|  |    |              |    |      |    |                              |    |      |    |              |    |  |
|  |    +——————————————+    +——————+    +——————————————————————————————+    +——————+    +——————————————+    |  |
|  |                                                                                                        |  |
|  |                                                                                                        |  |
|  |                                                                                                        |  |
|  |                                                                                                        |  |
|  +————————————————————————————————————————————————————————————————————————————————————————————————————————+  |
|                                                                                                              |
|                                                                                                              |
|                                                                                                              |
|                                                                                                              |
|                                                                                                              |
|                                                                                                              |
|                                                                                                              |
|                                                                                                              |
|                                                                                                              |
|                                                                                                              |
+——————————————————————————————————————————————————————————————————————————————————————————————————————————————+
