+——————————————————————————+
|                          |
|                          |
|——————————————————————————|
|      ++          ++      |
| +——+ || +——————+ || +——+ |
| +——+ ++ +——————+ ++ +——+ |
|                          |
+—+ ++ +———+ ++ +———+ ++ +—+
  | || |   | || |   | || |  
+—+ || +———+ || +———+ || +—+
    |+       ++       +|    
+—+ |———+ +——————+ +———| +—+
  | +———+ +——————+ +———+ |  
  |                      |  
  | +———+ +—+  +—+ +———+ |  
  | |———+ |      | +———| |  
  | |+    |      |    +| |  
  | || ++ |      | ++ || |  
+—+ ++ || +——————+ || ++ +—+
       ++          ++       
+—+ +——————+ ++ +——————+ +—+
  | +——————+ || +——————+ |  
  |          ++          |  
  | +———+ +——————+ +———+ |  
+—+ +———+ +——————+ +———+ +—+
|                          |
| +——+ +———+ ++ +———+ +——+ |
| |  | |———+ || +———| |  | |
| |  | |+    ++    +| |  | |
| |  | || +——————+ || |  | |
| +——+ ++ +——————+ ++ +——+ |
|                          |
|——————————————————————————|
|                          |
+——————————————————————————+
