+——————————————————————————————————————————————————————+
|                                                      |
|                                                      |
|                                                      |
|                                                      |
|                                                      |
|                                                      |
|—————————————+  +————————————————————+  +—————————————|
|+            |  |                    |  |            +|
||            |  |                    |  |            ||
||  +——————+  |  |  +——————————————+  |  |  +——————+  ||
||  |      |  |  |  |              |  |  |  |      |  ||
||  |      |  |  |  |              |  |  |  |      |  ||
||  +——————+  +——+  +——————————————+  +——+  +——————+  ||
||                                                    ||
|+                                                    +|
|————+  +——+  +————————+  +——+  +————————+  +——+  +————|
+————|  |  |  |        |  |  |  |        |  |  |  |————+
    +|  |  |  |        |  |  |  |        |  |  |  |+    
    +|  |  |  |        |  |  |  |        |  |  |  |+    
+————|  |  |  |        |  |  |  |        |  |  |  |————+
+————+  |  |  +————————+  |  |  +————————+  |  |  +————+
        |  |              |  |              |  |        
        |  |              |  |              |  |        
+————+  |  +—————+  +—————+  +—————+  +—————+  |  +————+
+————|  |        |  |              |  |        |  |————+
    +|  |        |  |              |  |        |  |+    
    ||  +————————+  +——————————————+  +————————+  ||    
    ||                                            ||    
    ||                                            ||    
    ||  +————————+  +————+    +————+  +————————+  ||    
    ||  |        |  |————+    +————|  |        |  ||    
    ||  |        |  |+            +|  |        |  ||    
    ||  |  +—————+  ||            ||  +—————+  |  ||    
    ||  |  |        ||            ||        |  |  ||    
    ||  |  |        ||            ||        |  |  ||    
    ||  |  |  +——+  ||            ||  +——+  |  |  ||    
    +|  |  |  |  |  |+            +|  |  |  |  |  |+    
+————|  |  |  |  |  |——————————————|  |  |  |  |  |————+
+————+  +——+  |  |  +——————————————+  |  |  +——+  +————+
              |  |                    |  |              
              |  |                    |  |              
+————+  +—————+  +—————+  +——+  +—————+  +—————+  +————+
+————|  |              |  |  |  |              |  |————+
    +|  |              |  |  |  |              |  |+    
    ||  +——————————————+  |  |  +——————————————+  ||    
    ||                    |  |                    ||    
    ||                    |  |                    ||    
    ||  +————————+  +—————+  +—————+  +————————+  ||    
    +|  |        |  |              |  |        |  |+    
+————|  |        |  |              |  |        |  |————+
|————+  +————————+  +——————————————+  +————————+  +————|
|+                                                    +|
||                                                    ||
||  +——————+  +————————+  +——+  +————————+  +——————+  ||
||  |      |  |        |  |  |  |        |  |      |  ||
||  |      |  |        |  |  |  |        |  |      |  ||
||  |      |  |  +—————+  |  |  +—————+  |  |      |  ||
||  |      |  |  |        |  |        |  |  |      |  ||
||  |      |  |  |        |  |        |  |  |      |  ||
||  |      |  |  |  +—————+  +—————+  |  |  |      |  ||
||  |      |  |  |  |              |  |  |  |      |  ||
||  |      |  |  |  |              |  |  |  |      |  ||
||  +——————+  +——+  +——————————————+  +——+  +——————+  ||
||                                                    ||
|+                                                    +|
|——————————————————————————————————————————————————————|
|                                                      |
|                                                      |
|                                                      |
|                                                      |
+——————————————————————————————————————————————————————+
