+——————————————————————————+
|                          |
|                          |
|——————————————————————————|
|                          |
| ++ +——+ +——————+ +——+ ++ |
| || |  | |——————| |  | || |
| || +——+ |+    +| +——+ || |
| |+      || ++ ||      +| |
| |——+ ++ || || || ++ +——| |
| +——+ || ++ || ++ || +——+ |
|      ++    ||    ++      |
+—+ +——————+ || +——————+ +—+
  | +——————+ ++ +——————+ |  
  |    ++          ++    |  
+—+ ++ || +—+  +—+ || ++ +—+
    +| ++ |      | ++ |+    
+————|    |      |    |————+
+————| ++ |      | ++ |————+
    +| || +——————+ || |+    
+—+ ++ |+          +| ++ +—+
  |    |———+ ++ +———|    |  
  | ++ +———+ || +———+ ++ |  
  | |+       ||       +| |  
  | |———+ ++ || ++ +———| |  
+—+ +———+ || ++ || +———+ +—+
|         |+    +|         |
| +——+ ++ |——————| ++ +——+ |
| |——+ || +——————+ || +——| |
| |+   ++          ++   +| |
| || +—————+ ++ +—————+ || |
| ++ +—————+ || +—————+ ++ |
|            ++            |
|——————————————————————————|
|                          |
+——————————————————————————+
