+——————————————————————————————————————————————————————————————————————————————————————————————————————————————+
|                                                                                                              |
|                                                                                                              |
|                                                                                                              |
|                                                                                                              |
|                                                                                                              |
|                                                                                                              |
|                                                                                                              |
|                                                                                                              |
|                                                                                                              |
|                                                                                                              |
|                                                                                                              |
|                                                                                                              |
|                                                                                                              |
|                                                                                                              |
+———————————————————————————+      +————————————————————————————————————————+      +———————————————————————————+
                            |      |                                        |      |                            
                            |      |                                        |      |                            
                            |      |                                        |      |                            
                            |      |                                        |      |                            
+——————————————————————+    |      |    +——————————————————————————————+    |      |    +——————————————————————+
|                      |    |      |    |                              |    |      |    |                      |
|                      |    |      |    |                              |    |      |    |                      |
|                      |    |      |    |                              |    |      |    |                      |
|                      |    |      |    |                              |    |      |    |                      |
|                      |    |      |    |                              |    |      |    |                      |
|                      |    |      |    |                              |    |      |    |                      |
|  +———————————————————+    +——————+    +———————————+      +———————————+    +——————+    +———————————————————+  |
|  |                                                |      |                                                |  |
|  |                                                |      |                                                |  |
|  |                                                |      |                                                |  |
|  |                                                |      |                                                |  |
|  |    +——————————————————————————+    +——————+    |      |    +——————+    +——————————————————————————+    |  |
|  |    |                          |    |      |    |      |    |      |    |                          |    |  |
|  |    |                          |    |      |    |      |    |      |    |                          |    |  |
|  |    |                          |    |      |    |      |    |      |    |                          |    |  |
|  |    |                          |    |      |    |      |    |      |    |                          |    |  |
|  |    |                          |    |      |    |      |    |      |    |                          |    |  |
|  |    |                          |    |      |    |      |    |      |    |                          |    |  |
|  |    |      +———————————————————+    |      |    |      |    |      |    +———————————————————+      |    |  |
|  |    |      |                        |      |    |      |    |      |                        |      |    |  |
|  |    |      |                        |      |    |      |    |      |                        |      |    |  |
|  |    |      |                        |      |    |      |    |      |                        |      |    |  |
|  |    |      |                        |      |    +——————+    |      |                        |      |    |  |
|  |    |      |    +——————————————+    |      |                |      |    +——————————————+    |      |    |  |
|  |    |      |    |              |    |      |                |      |    |              |    |      |    |  |
|  |    |      |    |              |    |      |                |      |    |              |    |      |    |  |
|  |    |      |    |              |    |      |                |      |    |              |    |      |    |  |
|  |    |      |    |              |    |      +————————————————+      |    |              |    |      |    |  |
|  |    |      |    |              |    |                              |    |              |    |      |    |  |
|  |    |      |    |              |    |                              |    |              |    |      |    |  |
|  |    +——————+    +———————+      |    |                              |    |      +———————+    +——————+    |  |
|  |                        |      |    |                              |    |      |                        |  |
|  |                        |      |    |                              |    |      |                        |  |
|  |                        |      |    |                              |    |      |                        |  |
|  |                        |      |    +——————————————————————————————+    |      |                        |  |
|  +———————————————————+    |      |                                        |      |    +———————————————————+  |
|                      |    |      |                                        |      |    |                      |
|                      |    |      |                                        |      |    |                      |
|                      |    |      |                                        |      |    |                      |
|                      |    |      |    +——————————+        +——————————+    |      |    |                      |
|                      |    |      |    |          |        |          |    |      |    |                      |
|                      |    |      |    |          |        |          |    |      |    |                      |
|  +———————————————————+    |      |    |  +———————+        +———————+  |    |      |    +———————————————————+  |
|  |                        |      |    |  |                        |  |    |      |                        |  |
|  |                        |      |    |  |                        |  |    |      |                        |  |
|  |                        |      |    |  |                        |  |    |      |                        |  |
|  |                        |      |    |  |                        |  |    |      |                        |  |
|  |    +——————————————+    |      |    |  |                        |  |    |      |    +——————————————+    |  |
|  |    |              |    |      |    |  |                        |  |    |      |    |              |    |  |
|  |    |              |    |      |    |  |                        |  |    |      |    |              |    |  |
|  |    |              |    +——————+    |  |                        |  |    +——————+    |              |    |  |
|  |    |              |                |  |                        |  |                |              |    |  |
|  |    |              |                |  |                        |  |                |              |    |  |
|  |    |              |                |  |                        |  |                |              |    |  |
|  |    +———————+      |                |  |                        |  |                |      +———————+    |  |
|  |            |      |    +——————+    |  +————————————————————————+  |    +——————+    |      |            |  |
|  |            |      |    |      |    |                              |    |      |    |      |            |  |
|  |            |      |    |      |    |                              |    |      |    |      |            |  |
|  |            |      |    |      |    +——————————————————————————————+    |      |    |      |            |  |
|  +———————+    |      |    |      |                                        |      |    |      |    +———————+  |
|          |    |      |    |      |                                        |      |    |      |    |          |
|          |    |      |    |      |                                        |      |    |      |    |          |
+———————+  |    |      |    |      |                                        |      |    |      |    |  +———————+
        |  |    |      |    |      +———————+    +——————————————+    +———————+      |    |      |    |  |        
        |  |    |      |    |              |    |              |    |              |    |      |    |  |        
        |  |    |      |    |              |    |              |    |              |    |      |    |  |        
        |  |    |      |    |              |    |              |    |              |    |      |    |  |        
        |  |    |      |    |              |    |              |    |              |    |      |    |  |        
        |  |    |      |    |              |    |              |    |              |    |      |    |  |        
        |  |    |      |    |              |    |              |    |              |    |      |    |  |        
        |  |    +——————+    +——————————————+    |              |    +——————————————+    +——————+    |  |        
        |  |                                    |              |                                    |  |        
        |  |                                    |              |                                    |  |        
        |  |                                    |              |                                    |  |        
        |  |                                    |              |                                    |  |        
        |  |    +——————————————————————————+    |              |    +——————————————————————————+    |  |        
        |  |    |                          |    |              |    |                          |    |  |        
        |  |    |                          |    |              |    |                          |    |  |        
        |  |    |                          |    |              |    |                          |    |  |        
+———————+  |    |                          |    |              |    |                          |    |  +———————+
|          |    |                          |    |              |    |                          |    |          |
|          |    |                          |    |              |    |                          |    |          |
+——————————+    +———————————+      +———————+    +——————————————+    +———————+      +———————————+    +——————————+
                            |      |                                        |      |                            
                            |      |                                        |      |                            
                            |      |                                        |      |                            
                            |      |                                        |      |                            
+——————————+    +——————+    |      |    +——————————————————————————————+    |      |    +——————+    +——————————+
|          |    |      |    |      |    |                              |    |      |    |      |    |          |
|          |    |      |    |      |    |                              |    |      |    |      |    |          |
|          |    |      |    |      |    |                              |    |      |    |      |    |          |
|          |    |      |    |      |    |                              |    |      |    |      |    |          |
|          |    |      |    |      |    |                              |    |      |    |      |    |          |
|          |    |      |    |      |    |                              |    |      |    |      |    |          |
|  +———————+    |      |    +——————+    +———————————+      +———————————+    +——————+    |      |    +———————+  |
|  |            |      |                            |      |                            |      |            |  |
|  |            |      |                            |      |                            |      |            |  |
|  |            |      |                            |      |                            |      |            |  |
|  |            |      |                            |      |                            |      |            |  |
|  |    +———————+      |    +——————————————————+    |      |    +——————————————————+    |      +———————+    |  |
|  |    |              |    |                  |    |      |    |                  |    |              |    |  |
|  |    |              |    |                  |    |      |    |                  |    |              |    |  |
|  |    |              |    |                  |    |      |    |                  |    |              |    |  |
|  |    |              |    |                  |    |      |    |                  |    |              |    |  |
|  |    |              |    |                  |    |      |    |                  |    |              |    |  |
|  |    |              |    |                  |    |      |    |                  |    |              |    |  |
|  |    +——————————————+    +——————————————————+    +——————+    +——————————————————+    +——————————————+    |  |
|  |                                                                                                        |  |
|  |                                                                                                        |  |
|  |                                                                                                        |  |
|  |                                                                                                        |  |
|  +————————————————————————————————————————————————————————————————————————————————————————————————————————+  |
|                                                                                                              |
|                                                                                                              |
|                                                                                                              |
|                                                                                                              |
|                                                                                                              |
|                                                                                                              |
|                                                                                                              |
|                                                                                                              |
|                                                                                                              |
|                                                                                                              |
+——————————————————————————————————————————————————————————————————————————————————————————————————————————————+
