+——————————————————————————+
|                          |
|                          |
+——————————————————————————+
       ++          ++       
+————+ || +——————+ || +————+
|————+ ++ +——————+ ++ +————|
|            ++            |
| +—————+ ++ || ++ +—————+ |
| |—————+ || || || +—————| |
| |+      || ++ ||      +| |
| || +——+ |+    +| +——+ || |
| ++ +——| |——————| |——+ ++ |
|      +| +——————+ |+      |
|————+ ||          || +————|
|————+ || +—+  +—+ || +————|
|      || |      | ||      |
| +——+ ++ |      | ++ +——+ |
| +——|    |      |    |——+ |
|   +| ++ +——————+ ++ |+   |
+—+ || |+          +| || +—+
  | || |——+ +——+ +——| || |  
  | ++ +——+ |  | +——+ ++ |  
  |         |  |         |  
  | +—————+ |  | +—————+ |  
+—+ +—————+ +——+ +—————+ +—+
       ++          ++       
+—+ ++ || +——————+ || ++ +—+
|—+ || ++ +——————+ ++ || +—|
|   +|       ++       |+   |
| +——| +———+ || +———+ |——+ |
| +——+ +———+ ++ +———+ +——+ |
|                          |
|——————————————————————————|
|                          |
+——————————————————————————+
