+——————————————————————————————————————————————————————————————————————————————————————————————————————————————+
|                                                                                                              |
|                                                                                                              |
|                                                                                                              |
|                                                                                                              |
|                                                                                                              |
|                                                                                                              |
|                                                                                                              |
|                                                                                                              |
|                                                                                                              |
|                                                                                                              |
|                                                                                                              |
|                                                                                                              |
|                                                                                                              |
|                                                                                                              |
|  +————————————————————————————————————————————————————————————————————————————————————————————————————————+  |
|  |                                                                                                        |  |
|  |                                                                                                        |  |
|  |                                                                                                        |  |
|  |                                                                                                        |  |
|  |    +——————+    +——————————————+    +——————————————————————————————+    +——————————————+    +——————+    |  |
|  |    |      |    |              |    |                              |    |              |    |      |    |  |
|  |    |      |    |              |    |                              |    |              |    |      |    |  |
|  |    |      |    |              |    |                              |    |              |    |      |    |  |
|  |    |      |    |              |    |                              |    |              |    |      |    |  |
|  |    |      |    |              |    |                              |    |              |    |      |    |  |
|  |    |      |    |              |    |                              |    |              |    |      |    |  |
|  |    |      |    |              |    |      +————————————————+      |    |              |    |      |    |  |
|  |    |      |    |              |    |      |                |      |    |              |    |      |    |  |
|  |    |      |    |              |    |      |                |      |    |              |    |      |    |  |
|  |    |      |    |              |    |      |                |      |    |              |    |      |    |  |
|  |    |      |    +——————————————+    |      |                |      |    +——————————————+    |      |    |  |
|  |    |      |                        |      |    +——————+    |      |                        |      |    |  |
|  |    |      |                        |      |    |      |    |      |                        |      |    |  |
|  |    |      |                        |      |    |      |    |      |                        |      |    |  |
|  |    |      |                        |      |    |      |    |      |                        |      |    |  |
|  |    |      +———————+    +——————+    |      |    |      |    |      |    +——————+    +———————+      |    |  |
|  |    |              |    |      |    |      |    |      |    |      |    |      |    |              |    |  |
|  |    |              |    |      |    |      |    |      |    |      |    |      |    |              |    |  |
|  |    |              |    |      |    |      |    |      |    |      |    |      |    |              |    |  |
|  |    |              |    |      |    |      |    |      |    |      |    |      |    |              |    |  |
|  |    |              |    |      |    |      |    |      |    |      |    |      |    |              |    |  |
|  |    |              |    |      |    |      |    |      |    |      |    |      |    |              |    |  |
|  |    +——————————————+    |      |    +——————+    |      |    +——————+    |      |    +——————————————+    |  |
|  |                        |      |                |      |                |      |                        |  |
|  |                        |      |                |      |                |      |                        |  |
|  |                        |      |                |      |                |      |                        |  |
|  |                        |      |                |      |                |      |                        |  |
|  +———————+    +———————————+      +———————————+    |      |    +———————————+      +———————————+    +———————+  |
|          |    |                              |    |      |    |                              |    |          |
|          |    |                              |    |      |    |                              |    |          |
+———————+  |    |                              |    |      |    |                              |    |  +———————+
        |  |    |                              |    |      |    |                              |    |  |        
        |  |    |                              |    |      |    |                              |    |  |        
        |  |    |                              |    |      |    |                              |    |  |        
        |  |    +———————————+      +———————————+    +——————+    +———————————+      +———————————+    |  |        
        |  |                |      |                                        |      |                |  |        
        |  |                |      |                                        |      |                |  |        
        |  |                |      |                                        |      |                |  |        
        |  |                |      |                                        |      |                |  |        
+———————+  |    +——————+    |      |    +——————————+        +——————————+    |      |    +——————+    |  +———————+
|          |    |      |    |      |    |          |        |          |    |      |    |      |    |          |
|          |    |      |    |      |    |          |        |          |    |      |    |      |    |          |
+——————————+    |      |    |      |    |  +———————+        +———————+  |    |      |    |      |    +——————————+
                |      |    |      |    |  |                        |  |    |      |    |      |                
                |      |    |      |    |  |                        |  |    |      |    |      |                
                |      |    |      |    |  |                        |  |    |      |    |      |                
                |      |    +——————+    |  |                        |  |    +——————+    |      |                
+———————————————+      |                |  |                        |  |                |      +———————————————+
|                      |                |  |                        |  |                |                      |
|                      |                |  |                        |  |                |                      |
|                      |                |  |                        |  |                |                      |
|                      |    +——————+    |  |                        |  |    +——————+    |                      |
|                      |    |      |    |  |                        |  |    |      |    |                      |
|                      |    |      |    |  |                        |  |    |      |    |                      |
+———————————————+      |    |      |    |  |                        |  |    |      |    |      +———————————————+
                |      |    |      |    |  +————————————————————————+  |    |      |    |      |                
                |      |    |      |    |                              |    |      |    |      |                
                |      |    |      |    |                              |    |      |    |      |                
                |      |    |      |    +——————————————————————————————+    |      |    |      |                
+——————————+    |      |    |      |                                        |      |    |      |    +——————————+
|          |    |      |    |      |                                        |      |    |      |    |          |
|          |    |      |    |      |                                        |      |    |      |    |          |
+———————+  |    +——————+    |      |                                        |      |    +——————+    |  +———————+
        |  |                |      +———————————+    +——————+    +———————————+      |                |  |        
        |  |                |                  |    |      |    |                  |                |  |        
        |  |                |                  |    |      |    |                  |                |  |        
        |  |                |                  |    |      |    |                  |                |  |        
        |  |    +——————+    |                  |    |      |    |                  |    +——————+    |  |        
        |  |    |      |    |                  |    |      |    |                  |    |      |    |  |        
        |  |    |      |    |                  |    |      |    |                  |    |      |    |  |        
        |  |    |      |    +——————————————————+    |      |    +——————————————————+    |      |    |  |        
        |  |    |      |                            |      |                            |      |    |  |        
        |  |    |      |                            |      |                            |      |    |  |        
        |  |    |      |                            |      |                            |      |    |  |        
        |  |    |      |                            |      |                            |      |    |  |        
        |  |    |      +———————————+    +——————+    |      |    +——————+    +———————————+      |    |  |        
        |  |    |                  |    |      |    |      |    |      |    |                  |    |  |        
        |  |    |                  |    |      |    |      |    |      |    |                  |    |  |        
        |  |    |                  |    |      |    |      |    |      |    |                  |    |  |        
+———————+  |    |                  |    |      |    |      |    |      |    |                  |    |  +———————+
|          |    |                  |    |      |    |      |    |      |    |                  |    |          |
|          |    |                  |    |      |    |      |    |      |    |                  |    |          |
|  +———————+    +——————————————————+    |      |    +——————+    |      |    +——————————————————+    +———————+  |
|  |                                    |      |                |      |                                    |  |
|  |                                    |      |                |      |                                    |  |
|  |                                    |      |                |      |                                    |  |
|  |                                    |      |                |      |                                    |  |
|  |    +——————————————+    +——————+    |      +————————————————+      |    +——————+    +——————————————+    |  |
|  |    |              |    |      |    |                              |    |      |    |              |    |  |
|  |    |              |    |      |    |                              |    |      |    |              |    |  |
|  |    |              |    |      |    |                              |    |      |    |              |    |  |
|  |    |              |    |      |    |                              |    |      |    |              |    |  |
|  |    |              |    |      |    |                              |    |      |    |              |    |  |
|  |    |              |    |      |    |                              |    |      |    |              |    |  |
|  |    |      +———————+    |      |    +——————————————————————————————+    |      |    +———————+      |    |  |
|  |    |      |            |      |                                        |      |            |      |    |  |
|  |    |      |            |      |                                        |      |            |      |    |  |
|  |    |      |            |      |                                        |      |            |      |    |  |
|  |    |      |            |      |                                        |      |            |      |    |  |
|  |    |      |    +———————+      +———————————+    +——————+    +———————————+      +———————+    |      |    |  |
|  |    |      |    |                          |    |      |    |                          |    |      |    |  |
|  |    |      |    |                          |    |      |    |                          |    |      |    |  |
|  |    |      |    |                          |    |      |    |                          |    |      |    |  |
|  |    |      |    |                          |    |      |    |                          |    |      |    |  |
|  |    |      |    |                          |    |      |    |                          |    |      |    |  |
|  |    |      |    |                          |    |      |    |                          |    |      |    |  |
|  |    +——————+    +——————————————————————————+    |      |    +——————————————————————————+    +——————+    |  |
|  |                                                |      |                                                |  |
|  |                                                |      |                                                |  |
|  |                                                |      |                                                |  |
|  |                                                |      |                                                |  |
|  +————————————————————————————————————————————————+      +————————————————————————————————————————————————+  |
|                                                                                                              |
|                                                                                                              |
|                                                                                                              |
|                                                                                                              |
|                                                                                                              |
|                                                                                                              |
|                                                                                                              |
|                                                                                                              |
|                                                                                                              |
|                                                                                                              |
+——————————————————————————————————————————————————————————————————————————————————————————————————————————————+
