+——————————————————————————+
|                          |
|                          |
|——————————————————————————|
|         ++    ++         |
| +—————+ || ++ || +—————+ |
| |—————+ ++ || ++ +—————| |
| |+         ||         +| |
| ++ ++ +——+ || +——+ ++ ++ |
|    || |  | || |  | ||    |
|——+ || +——+ ++ +——+ || +——|
+——+ |+              +| +——+
     |——+ +——————+ +——|     
+ ++ +——+ +——————+ +——+ ++ +
| |+                    +| |
| |——+ ++ +—+  +—+ ++ +——| |
| +——+ || |      | || +——+ |
|      +| |      | |+      |
| ++ +——| |      | |——+ ++ |
| || +——+ +——————+ +——+ || |
| |+                    +| |
| |——+ +———+ ++ +———+ +——| |
| +——+ |———+ || +———| +——+ |
|      |+    ++    +|      |
|—+ ++ || +——————+ || ++ +—|
|—+ || ++ +——————+ ++ || +—|
|   +|                |+   |
| +——| +———+ ++ +———+ |——+ |
| +——+ |———+ || +———| +——+ |
|      |+    ++    +|      |
| +——+ || +——————+ || +——+ |
| +——+ || +——————+ || +——+ |
|      ++          ++      |
|——————————————————————————|
|                          |
+——————————————————————————+
