+——————————————————————————————————————————————————————+
|                                                      |
|                                                      |
|                                                      |
|                                                      |
|                                                      |
|                                                      |
|—————————————————————————+  +—————————————————————————|
|+                        |  |                        +|
||                        |  |                        ||
||  +——————+  +————————+  |  |  +————————+  +——————+  ||
||  |      |  |        |  |  |  |        |  |      |  ||
||  |      |  |        |  |  |  |        |  |      |  ||
||  |      |  |        |  |  |  |        |  |      |  ||
||  |      |  |        |  |  |  |        |  |      |  ||
||  +——————+  +————————+  +——+  +————————+  +——————+  ||
||                                                    ||
||                                                    ||
||  +——————+  +——+  +——————————————+  +——+  +——————+  ||
||  |      |  |  |  |              |  |  |  |      |  ||
||  |      |  |  |  |              |  |  |  |      |  ||
||  +——————+  |  |  +—————+  +—————+  |  |  +——————+  ||
||            |  |        |  |        |  |            ||
|+            |  |        |  |        |  |            +|
|——————————+  |  +—————+  |  |  +—————+  |  +——————————|
+——————————|  |        |  |  |  |        |  |——————————+
          +|  |        |  |  |  |        |  |+          
          ||  |  +—————+  +——+  +—————+  |  ||          
          ||  |  |                    |  |  ||          
          ||  |  |                    |  |  ||          
          ||  |  |  +————+    +————+  |  |  ||          
          +|  |  |  |————+    +————|  |  |  |+          
+——————————|  |  |  |+            +|  |  |  |——————————+
+——————————+  +——+  ||            ||  +——+  +——————————+
                    ||            ||                    
                    ||            ||                    
+——————————+  +——+  ||            ||  +——+  +——————————+
+——————————|  |  |  |+            +|  |  |  |——————————+
          +|  |  |  |——————————————|  |  |  |+          
          ||  |  |  +——————————————+  |  |  ||          
          ||  |  |                    |  |  ||          
          ||  |  |                    |  |  ||          
          ||  |  |  +——————————————+  |  |  ||          
          +|  |  |  |              |  |  |  |+          
+——————————|  |  |  |              |  |  |  |——————————+
|——————————+  +——+  +—————+  +—————+  +——+  +——————————|
|+                        |  |                        +|
||                        |  |                        ||
||  +——————+  +————————+  |  |  +————————+  +——————+  ||
||  |      |  |        |  |  |  |        |  |      |  ||
||  |      |  |        |  |  |  |        |  |      |  ||
||  +———+  |  +————————+  +——+  +————————+  |  +———+  ||
||      |  |                                |  |      ||
|+      |  |                                |  |      +|
|————+  |  |  +——+  +——————————————+  +——+  |  |  +————|
|    |  |  |  |  |  |              |  |  |  |  |  |    |
|    |  |  |  |  |  |              |  |  |  |  |  |    |
|————+  +——+  |  |  +—————+  +—————+  |  |  +——+  +————|
|+            |  |        |  |        |  |            +|
||            |  |        |  |        |  |            ||
||  +—————————+  +—————+  |  |  +—————+  +—————————+  ||
||  |                  |  |  |  |                  |  ||
||  |                  |  |  |  |                  |  ||
||  +——————————————————+  +——+  +——————————————————+  ||
||                                                    ||
|+                                                    +|
|——————————————————————————————————————————————————————|
|                                                      |
|                                                      |
|                                                      |
|                                                      |
+——————————————————————————————————————————————————————+
