+——————————————————————————+
|                          |
|                          |
|——————————————————————————|
|            ++            |
| +——+ +———+ || +———+ +——+ |
| |  | |   | || |   | |  | |
| +——+ +———+ ++ +———+ +——+ |
|                          |
| +——+ ++ +——————+ ++ +——+ |
| +——+ || +——————+ || +——+ |
|      |+    ++    +|      |
+————+ |———+ || +———| +————+
     | |———+ ++ +———| |     
     | |+          +| |     
     | || +—+  +—+ || |     
+————+ ++ |      | ++ +————+
          |      |          
+————+ ++ |      | ++ +————+
     | || +——————+ || |     
     | ||          || |     
     | || +——————+ || |     
+————+ ++ +——————+ ++ +————+
|            ++            |
| +——+ +———+ || +———+ +——+ |
| +——| +———+ ++ +———+ |——+ |
|   +|                |+   |
|—+ || ++ +——————+ ++ || +—|
|—+ ++ || +——————+ || ++ +—|
|      ++    ++    ++      |
| +————————+ || +————————+ |
| +————————+ ++ +————————+ |
|                          |
|——————————————————————————|
|                          |
+——————————————————————————+
