+——————————————————————————————————————————————————————————————————————————————————————————————————————————————+
|                                                                                                              |
|                                                                                                              |
|                                                                                                              |
|                                                                                                              |
|                                                                                                              |
|                                                                                                              |
|                                                                                                              |
|                                                                                                              |
|                                                                                                              |
|                                                                                                              |
|                                                                                                              |
|                                                                                                              |
|                                                                                                              |
|                                                                                                              |
|  +————————————————————————————————————————————————+      +————————————————————————————————————————————————+  |
|  |                                                |      |                                                |  |
|  |                                                |      |                                                |  |
|  |                                                |      |                                                |  |
|  |                                                |      |                                                |  |
|  |    +——————————————+    +——————————————————+    |      |    +——————————————————+    +——————————————+    |  |
|  |    |              |    |                  |    |      |    |                  |    |              |    |  |
|  |    |              |    |                  |    |      |    |                  |    |              |    |  |
|  |    |              |    |                  |    |      |    |                  |    |              |    |  |
|  |    |              |    |                  |    |      |    |                  |    |              |    |  |
|  |    |              |    |                  |    |      |    |                  |    |              |    |  |
|  |    |              |    |                  |    |      |    |                  |    |              |    |  |
|  |    |              |    |                  |    |      |    |                  |    |              |    |  |
|  |    |              |    |                  |    |      |    |                  |    |              |    |  |
|  |    |              |    |                  |    |      |    |                  |    |              |    |  |
|  |    |              |    |                  |    |      |    |                  |    |              |    |  |
|  |    +——————————————+    +——————————————————+    +——————+    +——————————————————+    +——————————————+    |  |
|  |                                                                                                        |  |
|  |                                                                                                        |  |
|  |                                                                                                        |  |
|  |                                                                                                        |  |
|  |    +——————————————+    +——————+    +——————————————————————————————+    +——————+    +——————————————+    |  |
|  |    |              |    |      |    |                              |    |      |    |              |    |  |
|  |    |              |    |      |    |                              |    |      |    |              |    |  |
|  |    |              |    |      |    |                              |    |      |    |              |    |  |
|  |    |              |    |      |    |                              |    |      |    |              |    |  |
|  |    |              |    |      |    |                              |    |      |    |              |    |  |
|  |    |              |    |      |    |                              |    |      |    |              |    |  |
|  |    +——————————————+    |      |    +———————————+      +———————————+    |      |    +——————————————+    |  |
|  |                        |      |                |      |                |      |                        |  |
|  |                        |      |                |      |                |      |                        |  |
|  |                        |      |                |      |                |      |                        |  |
|  |                        |      |                |      |                |      |                        |  |
|  +———————————————————+    |      +———————————+    |      |    +———————————+      |    +———————————————————+  |
|                      |    |                  |    |      |    |                  |    |                      |
|                      |    |                  |    |      |    |                  |    |                      |
+———————————————————+  |    |                  |    |      |    |                  |    |  +———————————————————+
                    |  |    |                  |    |      |    |                  |    |  |                    
                    |  |    |                  |    |      |    |                  |    |  |                    
                    |  |    |                  |    |      |    |                  |    |  |                    
                    |  |    |      +———————————+    +——————+    +———————————+      |    |  |                    
                    |  |    |      |                                        |      |    |  |                    
                    |  |    |      |                                        |      |    |  |                    
                    |  |    |      |                                        |      |    |  |                    
                    |  |    |      |                                        |      |    |  |                    
                    |  |    |      |    +——————————+        +——————————+    |      |    |  |                    
                    |  |    |      |    |          |        |          |    |      |    |  |                    
                    |  |    |      |    |          |        |          |    |      |    |  |                    
                    |  |    |      |    |  +———————+        +———————+  |    |      |    |  |                    
+———————————————————+  |    |      |    |  |                        |  |    |      |    |  +———————————————————+
|                      |    |      |    |  |                        |  |    |      |    |                      |
|                      |    |      |    |  |                        |  |    |      |    |                      |
+——————————————————————+    +——————+    |  |                        |  |    +——————+    +——————————————————————+
                                        |  |                        |  |                                        
                                        |  |                        |  |                                        
                                        |  |                        |  |                                        
                                        |  |                        |  |                                        
+——————————————————————+    +——————+    |  |                        |  |    +——————+    +——————————————————————+
|                      |    |      |    |  |                        |  |    |      |    |                      |
|                      |    |      |    |  |                        |  |    |      |    |                      |
+———————————————————+  |    |      |    |  |                        |  |    |      |    |  +———————————————————+
                    |  |    |      |    |  +————————————————————————+  |    |      |    |  |                    
                    |  |    |      |    |                              |    |      |    |  |                    
                    |  |    |      |    |                              |    |      |    |  |                    
                    |  |    |      |    +——————————————————————————————+    |      |    |  |                    
                    |  |    |      |                                        |      |    |  |                    
                    |  |    |      |                                        |      |    |  |                    
                    |  |    |      |                                        |      |    |  |                    
                    |  |    |      |                                        |      |    |  |                    
                    |  |    |      |    +——————————————————————————————+    |      |    |  |                    
                    |  |    |      |    |                              |    |      |    |  |                    
                    |  |    |      |    |                              |    |      |    |  |                    
                    |  |    |      |    |                              |    |      |    |  |                    
+———————————————————+  |    |      |    |                              |    |      |    |  +———————————————————+
|                      |    |      |    |                              |    |      |    |                      |
|                      |    |      |    |                              |    |      |    |                      |
|  +———————————————————+    +——————+    +———————————+      +———————————+    +——————+    +———————————————————+  |
|  |                                                |      |                                                |  |
|  |                                                |      |                                                |  |
|  |                                                |      |                                                |  |
|  |                                                |      |                                                |  |
|  |    +——————————————+    +——————————————————+    |      |    +——————————————————+    +——————————————+    |  |
|  |    |              |    |                  |    |      |    |                  |    |              |    |  |
|  |    |              |    |                  |    |      |    |                  |    |              |    |  |
|  |    |              |    |                  |    |      |    |                  |    |              |    |  |
|  |    |              |    |                  |    |      |    |                  |    |              |    |  |
|  |    |              |    |                  |    |      |    |                  |    |              |    |  |
|  |    |              |    |                  |    |      |    |                  |    |              |    |  |
|  |    +———————+      |    +——————————————————+    +——————+    +——————————————————+    |      +———————+    |  |
|  |            |      |                                                                |      |            |  |
|  |            |      |                                                                |      |            |  |
|  |            |      |                                                                |      |            |  |
|  |            |      |                                                                |      |            |  |
|  +———————+    |      |    +——————+    +——————————————————————————————+    +——————+    |      |    +———————+  |
|          |    |      |    |      |    |                              |    |      |    |      |    |          |
|          |    |      |    |      |    |                              |    |      |    |      |    |          |
|          |    |      |    |      |    |                              |    |      |    |      |    |          |
|          |    |      |    |      |    |                              |    |      |    |      |    |          |
|          |    |      |    |      |    |                              |    |      |    |      |    |          |
|          |    |      |    |      |    |                              |    |      |    |      |    |          |
|  +———————+    +——————+    |      |    +———————————+      +———————————+    |      |    +——————+    +———————+  |
|  |                        |      |                |      |                |      |                        |  |
|  |                        |      |                |      |                |      |                        |  |
|  |                        |      |                |      |                |      |                        |  |
|  |                        |      |                |      |                |      |                        |  |
|  |    +———————————————————+      +———————————+    |      |    +———————————+      +———————————————————+    |  |
|  |    |                                      |    |      |    |                                      |    |  |
|  |    |                                      |    |      |    |                                      |    |  |
|  |    |                                      |    |      |    |                                      |    |  |
|  |    |                                      |    |      |    |                                      |    |  |
|  |    |                                      |    |      |    |                                      |    |  |
|  |    |                                      |    |      |    |                                      |    |  |
|  |    +——————————————————————————————————————+    +——————+    +——————————————————————————————————————+    |  |
|  |                                                                                                        |  |
|  |                                                                                                        |  |
|  |                                                                                                        |  |
|  |                                                                                                        |  |
|  +————————————————————————————————————————————————————————————————————————————————————————————————————————+  |
|                                                                                                              |
|                                                                                                              |
|                                                                                                              |
|                                                                                                              |
|                                                                                                              |
|                                                                                                              |
|                                                                                                              |
|                                                                                                              |
|                                                                                                              |
|                                                                                                              |
+——————————————————————————————————————————————————————————————————————————————————————————————————————————————+
